111111111111111111111111111111111111111111111111111111111111111111111111111111111111111111111111111111111111111111111111111111
111111111111111111111111111111111111111111111111111111111111111111111111111111111111111111111111111111111111111111111111111111
1111111111111111111................1111111111111111111111111111111111111111111..........................1111111111111111111111
11111111111111.............................11111111111111111111111111111111................................1111111111111111111
1111111111..................................1111111111111111111111111111.....................................11111111111111111
111111111....................................1111111111111111111111111.........................................111111111111111
111111111.............P.......................1111111111111111111111..............................................111111111111
111111111.....M................................111111111111111111111...............................................11111111111
111111111..............111111111...............111111111111111111111..................11111111111..................11111111111
11111111..............11111111111..............111111111111111111111................11111111111111111..............11111111111
11111111.............1111111111111.............111111111111111111111..............11111111111111111111.............11111111111
11111111.............1111111111111.............11111111111111111111..............1111111111111111111111.............1111111111
11111111.............1111111111111.............11111111111111111111..............1111111111111111111111.............1111111111
11111111.............1111111111111..............111111111111111111...............11111111111111111111111............1111111111
11111111.............1111111111111..............111111111111111111..............111111111111111111111111............1111111111
11111111............11111111111111..............111111111111111111..............111111111111111111111111............1111111111
11111111............111111111111111.............11111111111111111...............111111111111111111111111............1111111111
1111111............1111111111111111..............1111111111111111..............111111111111111111111111............11111111111
1111111............1111111111111111..............1111111111111111..............111111111111111111111111............11111111111
1111111...........111111111111111111.............1111111111111111..............11111111111111111111111............111111111111
1111111..........1111111111111111111.............1111111111111111..............1111111111111111111111.............111111111111
111111...........1111111111111111111.............111111111111111...............1111111111111111111111.............111111111111
111111...........1111111111111111111..............1111111111111................111111111111111111111.............1111111111111
111111...........1111111111111111111...............11111111111.................111111111111111111111.............1111111111111
111111...........1111111111111111111..........................................111111111111111111111..............1111111111111
111111...........11111111111111111111........................................111111111111111111111..............11111111111111
111111...........1111111111111111111111.....................................111111111111111111111...............11111111111111
111111...........11111111111111111111111..................................1111111111111111111111...............111111111111111
111111............11111111111111111111111111111.........................11111111111111111111111...............1111111111111111
111111.............1111111111111111111111111111111111..............11111111111111111111111111.................1111111111111111
111111.................1111111111111111111111111111111111111111111111111111111111111111111..................111111111111111111
111111.........................1111111111111111111111111111111111111111111111111111........................1111111111111111111
111111..................................1111111111111111111111111111111111...............................111111111111111111111
1111111......................................111111111111111111111111111................................1111111111111111111111
111111111111....................................1111111111111111111111..............................11111111111111111111111111
1111111111111111.................................11111111111111111.............................1111111111111111111111111111111
1111111111111111111111111........................1111111111111111...........................1111111111111111111111111111111111
11111111111111111111111111111....................111111111111111..................11111111111111111111111111111111111111111111
111111111111111111111111111111111111..............11111111111111............11111111111111111111111111111111111111111111111111
111111111111111111111111111111111111111...........11111111111111...........111111111111111111111111111111111111111111111111111
111111111111111111111111111111111111111...........11111111111111...........111111111111111111111111111111111111111111111111111
111111111111111111111111111111111111111...........11111111111111...........111111111111111111111111111111111111111111111111111
111111111111111111111111111111111111111...........1111111111111............111111111111111111111111111111111111111111111111111
111111111111111111111111111111111111111...........1111111111111...........1111111111111111111111111111111111111111111111111111
111111111111111111111111111111111111111............111111111111...........1111111111111111111111111111111111111111111111111111
1111111111111111111111111111111111111111...........111111111111...........1111111111111111111111111111111111111111111111111111
1111111111111111111111111111111111111111............1111111111............1111111111111111111111111111111111111111111111111111
1111111111111111111111111111111111111111............111111111.............1111111111111111111111111111111111111111111111111111
1111111111111111111111111111111111111111.............11111111.............1111111111111111111111111111111111111111111111111111
11111111111111111111111111111111111111111................................11111111111111111111111111111111111111111111111111111
111111111111111111111111111111111111111111...............................11111111111111111111111111111111111111111111111111111
1111111111111111111111111111111111111111111..............................11111111111111111111111111111111111111111111111111111
111111111111111111111111111111111111111111111...........................111111111111111111111111111111111111111111111111111111
11111111111111111111111111111111111111111111111.......................11111111111111111111111111111111111111111111111111111111
111111111111111111111111111111111111111111111111111................11111111111111111111111111111111111111111111111111111111111
111111111111111111111111111111111111111111111111111111111111111111111111111111111111111111111111111111111111111111111111111111
111111111111111111111111111111111111111111111111111111111111111111111111111111111111111111111111111111111111111111111111111111