111111111111111111111111111111111111111111111111111111111111111111111111111111111111111111111111111111111111111111111111111111
111111111111111111111111111111111111111111111111111111111111111111111111111111111111111111111111111111111111111111111111111111
1111111111111111111................1111111111111111111111111111111111111111111..........................1111111111111111111111
11111111111111.............................11111111111111111111111111111111................................1111111111111111111
1111111111...................................111111111111111111111111111.....................................11111111111111111
111111111......................................11111111111111111111111.........................................111111111111111
11111111..............P.........................11111111111111111111..............................................111111111111
11111111......M..................................11111111111111111.................................................11111111111
11111111..............111111111111...............1111111111111111..............111111111111111111..................11111111111
1111111.............11111111111111111............111111111111111..............q111111111111111111111111.............11111111111
1111111.............1111111111111111111..........111111111111111.............11111111111111111111111111............11111111111
1111111.............11111111111111111111.........111111111111111............111111111111111111111111111.............1111111111
1111111.............11111111111111111111.........111111111111111............111111111111111111111111111.............1111111111
1111111.............11111111111111111111.........111111111111111............1111111111111111111111111111............1111111111
1111111.............1111111111111111111..........1111111111111111...........1111111111111111111111111111............1111111111
1111111..............11111111111111111...........1111111111111111...........1111111111111111111111111111............1111111111
1111111..............1111111111111111............1111111111111111............111111111111111111111111111............1111111111
11111111.............111111111111111............11111111111111111............111111111111111111111111111............1111111111
11111111.............11111111111111............111111111111111111............111111111111111111111111111............1111111111
11111111.............1111111111111............11111111111111111111...........11111111111111111111111111.............1111111111
11111111.............1111111111111............11111111111111111111............1111111111111111111111111............11111111111
11111111.............111111111111.............11111111111111111111.............111111111111111111111111............11111111111
1111111.............1111111111111.............11111111111111111111.............111111111111111111111111............11111111111
1111111............11111111111111.............111111111111111111111............111111111111111111111111............11111111111
1111111............11111111111111.............111111111111111111111............111111111111111111111111............11111111111
1111111...........1111111111111111............111111111111111111111............11111111111111111111111............111111111111
1111111..........11111111111111111............11111111111111111111.............1111111111111111111111............1111111111111
111111...........111111111111111111............1111111111111111111.............1111111111111111111111............1111111111111
111111...........111111111111111111.............11111111111111111..............111111111111111111111.............1111111111111
111111...........1111111111111111111...............11111111111.................111111111111111111111............11111111111111
111111...........1111111111111111111..........................................111111111111111111111.............11111111111111
111111...........11111111111111111111........................................111111111111111111111..............11111111111111
111111...........1111111111111111111111.....................................11111111111111111111...............111111111111111
111111...........11111111111111111111111..................................111111111111111111111................111111111111111
111111............11111111111111111111111111111.........................111111111111111111111.................1111111111111111
111111.............1111111111111111111111111111111111..............1111111111111111111111111..................1111111111111111
111111.................1111111111111111111111111111111111111111111111111111111111111111111..................111111111111111111
111111.........................1111111111111111111111111111111111111111111111111111........................1111111111111111111
11111111........................................111111111111111111111....................................111111111111111111111
1111111111..............................................................................................1111111111111111111111
1111111111111.......................................................................................11111111111111111111111111
1111111111111111...............................................................................1111111111111111111111111111111
111111111111111111111.......................................................................1111111111111111111111111111111111
111111111111111111111111111111111....................................................11111111111111111111111111111111111111111
1111111111111111111111111111111111111111.....................................1111111111111111111111111111111111111111111111111
111111111111111111111111111111111111111111111111111111111111111111111111111111111111111111111111111111111111111111111111111111
111111111111111111111111111111111111111111111111111111111111111111111111111111111111111111111111111111111111111111111111111111